#50,80
g1 t1 g1 g1 g1 g1 g1 g1 g1 g1 g1 g1 g1 g1 t1 t1 g1 t1 t1 t1 t1 t1 t1 g1 g1 g1 g1 g1 g1 g1 g1 g1 g1 g1 g1 g1 g1 g1 g1 g1 g1 g1 g1 g1 g1 g1 g1 g1 g1 g1 g1 g1 g1 g1 g1 g1 g1 g1 g1 g1 g1 g1 g1 g1 g1 g1 g1 g1 g1 g1 g1 g1 g1 g1 g1 g1 g1 g1 g1 g1
g1 g1 g1 g1 g1 g1 g1 g1 g1 g1 g1 g1 g1 g1 t1 t1 g1 t1 t1 t1 t1 t1 g1 g1 g1 g1 g1 g1 g1 g1 g1 g1 g1 g1 g1 g1 g1 g1 g1 g1 g1 g1 g1 g1 g1 g1 g1 g1 g1 g1 g1 g1 g1 g1 g1 g1 g1 g1 g1 g1 g1 g1 g1 g1 g1 g1 g1 g1 g1 g1 g1 g1 g1 g1 g1 g1 g1 g1 g1 g1
g1 g1 g1 g1 g1 g1 t1 t1 g1 g1 g1 g1 t2 t1 t1 t1 g1 t1 t1 t1 t1 g1 g1 g1 g1 g1 g1 g1 g1 g1 g1 g1 g1 g1 g1 g1 g1 g1 g1 g1 g1 g1 g1 g1 g1 g1 g1 g1 g1 g1 g1 g1 g1 g1 g1 g1 g1 g1 g1 g1 g1 g1 g1 g1 g1 g1 g1 g1 g1 g1 g1 g1 g1 g1 g1 g1 g1 g1 g1 g1
g1 g1 g1 g1 g1 g1 g1 g1 g1 g1 g1 g1 g1 t2 t2 t1 g1 t1 t1 t1 t1 g1 g1 g1 g1 g1 g1 g1 g1 g1 g1 g1 g1 g1 g1 g1 g1 g1 g1 g1 g1 g1 g1 g1 g1 g1 g1 g1 g1 g1 g1 g1 g1 g1 g1 g1 g1 g1 g1 g1 g1 g1 g1 g1 g1 g1 g1 g1 g1 g1 g1 g1 g1 g1 g1 g1 g1 g1 g1 g1
g1 g1 g1 g1 g1 g1 g1 g1 g1 g1 g1 g1 g1 g1 t1 t1 g1 t1 t1 t1 t1 g1 g1 g1 g1 g1 g1 g1 g1 g1 g1 g1 g1 g1 g1 g1 g1 g1 g1 g1 g1 g1 g1 g1 g1 g1 g1 g1 g1 g1 g1 g1 g1 g1 g1 g1 g1 g1 g1 g1 g1 g1 g1 g1 g1 g1 g1 g1 g1 g1 g1 g1 g1 g1 g1 g1 g1 g1 g1 g1
g1 g1 g1 g1 t1 t1 t1 g1 g1 g1 g1 g1 g1 g1 t1 t1 g1 t1 t1 g1 g1 g1 g1 g1 g1 g1 g1 g1 g1 g1 g1 g1 g1 g1 g1 g1 g1 g1 g1 g1 g1 g1 g1 g1 g1 g1 g1 g1 g1 g1 g1 g1 g1 g1 g1 g1 g1 g1 g1 g1 g1 g1 g1 g1 g1 g1 g1 g1 g1 g1 g1 g1 g1 g1 g1 g1 g1 g1 g1 g1
g1 g1 g1 g1 t1 t2 t1 g1 g1 g1 g1 g1 g1 g1 g1 g1 g1 t1 t1 g1 g1 g1 g1 g1 g1 g1 g1 g1 g1 g1 g1 g1 g1 g1 g1 g1 g1 g1 g1 g1 g1 g1 g1 g1 g1 g1 g1 g1 g1 g1 g1 g1 g1 g1 g1 g1 g1 g1 g1 g1 g1 g1 g1 g1 g1 g1 g1 g1 g1 g1 g1 g1 g1 g1 g1 g1 g1 g1 g1 g1
t2 t2 t2 g1 g2 t1 g1 g1 g1 g1 g1 g1 g1 g1 g1 g1 g1 g1 g1 g1 g1 g1 g1 g1 g1 g1 g1 g1 g1 g1 g1 g1 g1 g1 g1 g1 g1 g1 g1 g1 g1 g1 g1 g1 g1 g1 g1 g1 g1 g1 g1 g1 g1 g1 g1 g1 g1 g1 g1 g1 g1 g1 g1 g1 g1 g1 g1 g1 g1 g1 g1 g1 g1 g1 g1 g1 g1 g1 g1 g1
g1 t2 t2 t2 g1 t1 g1 g1 g1 g1 g1 g1 g1 g1 g1 g1 g1 g1 g1 g1 g1 g1 g1 g1 g1 g1 g1 g1 g1 g1 g1 g1 g1 g1 g1 g1 g1 g1 g1 g1 g1 g1 g1 g1 g1 g1 g1 g1 g1 g1 g1 g1 g1 g1 g1 g1 g1 g1 g1 g1 g1 g1 g1 g1 g1 g1 g1 g1 g1 g1 g1 g1 g1 g1 g1 g1 g1 g1 g1 g1
t1 t1 t1 t2 g1 t1 g1 t2 g1 g1 g1 g1 g1 g1 g1 g1 g1 g1 g1 g1 g1 g1 g1 g1 g1 g1 g1 g1 g1 g1 g1 g1 g1 g1 g1 g1 g1 g1 g1 g1 g1 g1 g1 g1 g1 g1 g1 g1 g1 g1 g1 g1 g1 g1 g1 g1 g1 g1 g1 g1 g1 g1 g1 g1 g1 g1 g1 g1 g1 g1 g1 g1 g1 g1 g1 g1 g1 g1 g1 g1
s2 s2 t1 t2 g1 g1 g1 g1 g1 g1 g1 g1 g1 g1 g1 g1 g1 g1 g1 g1 g1 g1 g1 g1 g1 g1 g1 g1 g1 g1 g1 g1 g1 g1 s1 s1 g1 g1 g1 g1 g1 g1 g1 g1 g1 g1 g1 g1 g1 g1 g1 g1 g1 g1 g1 g1 g1 g1 g1 g1 g1 g1 g1 g1 g1 g1 g1 g1 g1 g1 g1 g1 g1 g1 g1 g1 g1 g1 g1 g1
s2 s2 s2 t2 g1 g1 g1 g1 g1 g1 g1 g1 g1 g1 g1 g1 g1 g1 g1 g1 g1 g1 g1 g1 g1 g1 g1 g1 g1 g1 g1 g1 s1 s2 s2 s1 g1 g1 g1 g1 g1 g1 g1 g1 g1 g1 g1 g1 g1 g1 g1 g1 g1 g1 g1 g1 g1 g1 g1 g1 g1 g1 g1 g1 g1 g1 g1 g1 g1 g1 g1 g1 g1 g1 g1 g1 g1 g1 g1 g1
s2 s2 s2 g1 g1 g1 g1 g1 g1 g1 g1 g1 g1 g1 g1 g1 g1 g1 g1 g1 g1 g1 g1 g1 g1 g1 g1 g1 g1 g1 g1 g1 s1 s1 s1 g1 g1 g1 g1 g1 g1 g1 g1 g1 g1 g1 g1 g1 g1 g1 g1 g1 g1 g1 g1 g1 g1 g1 g1 g1 g1 g1 g1 g1 g1 g1 g1 g1 g1 g1 g1 g1 g1 g1 g1 g1 g1 g1 g1 g1
s1 s2 s2 g1 g1 g1 g1 g1 g1 g1 g1 g1 g1 g1 g1 g1 g1 g1 g1 g2 g1 g1 g1 g1 g1 g1 g1 g1 g1 g1 g1 g1 s1 s1 s1 g1 g1 g1 g1 g1 g1 g1 g1 g1 g1 g1 g1 g1 g1 g1 g1 g1 g1 g1 g1 g1 g1 g1 g1 g1 g1 g1 g1 g1 g1 g1 g1 g1 g1 g1 g1 g1 g1 g1 g1 g1 g1 g1 g1 g1
s1 s2 s2 g1 g1 g1 g1 g1 g1 g1 g1 g1 g1 g1 g1 g1 g1 g1 g1 g1 g1 g1 g1 g1 g1 g1 g1 g1 g1 g1 g1 g1 g1 g1 g1 g1 g1 g1 g1 g1 g1 g1 g1 g1 g1 g1 g1 g1 g1 g1 g1 g1 g1 g1 g1 g1 g1 g1 g1 g1 g1 g1 g1 g1 g1 g1 g1 g1 g1 g1 g1 g1 g1 g1 g1 g1 g1 g1 g1 g1
s2 s1 s2 s1 g1 g1 g1 g1 g1 g1 g1 g1 g1 g1 g1 g1 g1 g1 g1 g1 g1 g1 g1 g1 s1 s1 s1 g1 g1 g1 g1 g1 g1 g1 g1 g1 g1 g1 g1 g1 g1 g1 g1 g1 g1 g1 g1 g1 g1 g1 g1 g1 g1 g1 g1 g1 g1 g1 g1 g1 g1 g1 g1 g1 g1 g1 g1 g1 g1 g1 g1 g1 g1 g1 g1 g1 g1 g1 g1 g1
s1 s1 s2 s1 s1 s1 s1 g1 g1 g1 g1 g1 g1 g1 g1 g1 g1 g1 g1 g1 g1 g1 g1 g1 s1 g1 s1 g1 g1 g1 g1 g1 g1 g1 g1 g1 g1 g1 g1 g1 g1 g1 g1 g1 g1 g1 g1 g1 g1 g1 g1 g1 g1 g1 g1 g1 g1 g1 g1 g1 g1 g1 g1 g1 g1 g1 g1 g1 g1 g1 g1 g1 g1 g1 g1 g1 g1 g1 g1 g1
g1 g1 s2 s2 s2 s2 s2 g1 g1 g1 g1 g1 g1 g1 g1 g1 g1 g1 g1 g1 g1 g1 g1 g1 s1 s1 s1 g1 g1 g1 g1 g1 g1 g1 g1 g1 g1 g1 g1 g1 g1 g1 g1 g1 g1 g1 g1 g1 g1 g1 g1 g1 g1 g1 g1 g1 g1 g1 g1 g1 g1 g1 g1 g1 g1 g1 g1 g1 g1 g1 g1 g1 g1 g1 g1 g1 g1 g1 g1 g1
g1 g1 s2 g1 g1 s1 s1 s1 s1 s1 s1 g1 g1 g1 t1 t1 g1 g1 g1 g1 g1 g1 g1 g1 g1 g2 g1 g1 g1 g1 g1 g1 g1 g1 g1 g1 g1 g1 g1 g1 g1 g1 g1 g1 g1 g1 g1 g1 g1 g1 g1 g1 g1 g1 g1 g1 g1 g1 g1 g1 g1 g1 g1 g1 g1 g1 g1 g1 g1 g1 g1 g1 g1 g1 g1 g1 g1 g1 g1 g1
g1 g1 s2 g1 s1 s1 s1 g1 g1 g1 g1 g1 g1 g1 t1 t2 g1 g1 g1 g1 g1 g1 g1 g1 g1 g1 g1 g1 g1 g1 g1 g1 g1 g1 g1 g1 g1 g1 g1 g1 g1 g1 g1 g1 g1 g1 g1 g1 g1 g1 g1 g1 g1 g1 g1 g1 g1 g1 g1 g1 g1 g1 g1 g1 g1 g1 g1 g1 g1 g1 g1 g1 g1 g1 g1 g1 g1 g1 g1 g1
g1 g1 g1 g1 g1 g1 g1 g1 g1 g1 g1 g1 g1 g1 t1 t1 g1 g1 g1 g1 g1 g1 g1 g1 g1 g1 g1 g1 g1 g1 g1 g1 g1 g1 g1 g1 g1 g1 g1 g1 g1 g1 g1 g1 g1 g1 g1 g1 g1 g1 g1 g1 g1 g1 g1 g1 g1 g1 g1 g1 g1 g1 g1 g1 g1 g1 g1 g1 g1 g1 g1 g1 g1 g1 g1 g1 g1 g1 g1 g1
g1 g1 g1 g1 g1 g1 g1 g1 g1 g1 g1 g1 g1 g1 g1 g1 g1 g1 g1 g1 g1 g1 g1 g1 g1 g1 g1 g1 g1 g1 g1 g1 g1 g1 g1 g1 g1 g1 g1 g1 g1 g1 g1 g1 g1 g1 g1 g1 g1 g1 g1 g1 g1 g1 g1 g1 g1 g1 g1 g1 g1 g1 g1 g1 g1 g1 g1 g1 g1 g1 g1 g1 g1 g1 g1 g1 g1 g1 g1 g1
g1 g1 g1 g1 g1 g1 g1 g1 g1 g1 g1 g1 g1 g1 g1 g1 g1 g1 g1 g1 g1 g1 g1 g1 g1 g1 g1 g1 g1 g1 g1 g1 g1 g1 g1 g1 g1 g1 g1 g1 g1 g1 g1 g1 g1 g1 g1 g1 g1 g1 g1 g1 g1 g1 g1 g1 g1 g1 g1 g1 g1 g1 g1 g1 g1 g1 g1 g1 g1 g1 g1 g1 g1 g1 g1 g1 g1 g1 g1 g1
g1 g1 g1 g1 g1 g1 g1 g1 g1 g1 g1 g1 g1 g1 g1 g1 g1 g1 g1 g1 g1 g1 g1 g1 g1 g1 g1 g1 g1 g1 g1 g1 g1 g1 g1 g1 g1 g1 g1 g1 g1 g1 g1 g1 g1 g1 g1 g1 g1 g1 g1 g1 g1 g1 g1 g1 g1 g1 g1 g1 g1 g1 g1 g1 g1 g1 g1 g1 g1 g1 g1 g1 g1 g1 g1 g1 g1 g1 g1 g1
g1 g1 g1 g1 g1 g1 g1 g1 g1 g1 g1 g1 g1 g1 g1 g1 g1 g1 g1 g1 g1 g1 g1 g1 g1 g1 g1 g1 g1 g1 g1 g1 g1 g1 g1 g1 g1 g1 g1 g1 g1 g1 g1 g1 g1 g1 g1 g1 g1 g1 g1 g1 g1 g1 g1 g1 g1 g1 g1 g1 g1 g1 g1 g1 g1 g1 g1 g1 g1 g1 g1 g1 g1 g1 g1 g1 g1 g1 g1 g1
g1 g1 g1 g1 g1 g1 g1 g1 g1 g1 g1 g1 g1 g1 g1 g1 g1 g1 g1 g1 g1 g1 g1 g1 g1 g1 g1 g1 g1 g1 g1 g1 g1 g1 g1 g1 g1 g1 g1 g1 g1 g1 g1 g1 g1 g1 g1 g1 g1 g1 g1 g1 g1 g1 g1 g1 g1 g1 g1 g1 g1 g1 g1 g1 g1 g1 g1 g1 g1 g1 g1 g1 g1 g1 g1 g1 g1 g1 g1 g1
g1 g1 g1 g1 g1 g1 g1 g1 g1 g1 g1 g1 g1 g1 g1 g1 g1 g1 g1 g1 g1 g1 g1 g1 g1 g1 g1 g1 g1 g1 g1 g1 g1 g1 g1 g1 g1 g1 g1 g1 g1 g1 g1 g1 g1 g1 g1 g1 g1 g1 g1 g1 g1 g1 g1 g1 g1 g1 g1 g1 g1 g1 g1 g1 g1 g1 g1 g1 g1 g1 g1 g1 g1 g1 g1 g1 g1 g1 g1 g1
g1 g1 g1 g1 g1 g1 g1 g1 g1 g1 g1 g1 g1 g1 g1 g1 g1 g1 g1 g1 g1 g1 g1 g1 g1 g1 g1 g1 g1 g1 g1 g1 g1 g1 g1 g1 g1 g1 g1 g1 g1 g1 g1 g1 g1 g1 g1 g1 g1 g1 g1 g1 g1 g1 g1 g1 g1 g1 g1 g1 g1 g1 g1 g1 g1 g1 g1 g1 g1 g1 g1 g1 g1 g1 g1 g1 g1 g1 g1 g1
g1 g1 g1 g1 g1 g1 g1 g1 g1 g1 g1 g1 g1 g1 g1 g1 g1 g1 g1 g1 g1 g1 g1 g1 g1 g1 g1 g1 g1 g1 g1 g1 g1 g1 g1 g1 g1 g1 g1 g1 g1 g1 g1 g1 g1 g1 g1 g1 g1 g1 g1 g1 g1 g1 g1 g1 g1 g1 g1 g1 g1 g1 g1 g1 g1 g1 g1 g1 g1 g1 g1 g1 g1 g1 g1 g1 g1 g1 g1 g1
g1 g1 g1 g1 g1 g1 g1 g1 g1 g1 g1 g1 g1 g1 g1 g1 g1 g1 g1 g1 g1 g1 g1 g1 g1 g1 g1 g1 g1 g1 g1 g1 g1 g1 g1 g1 g1 g1 g1 g1 g1 g1 g1 g1 g1 g1 g1 g1 g1 g1 g1 g1 g1 g1 g1 g1 g1 g1 g1 g1 g1 g1 g1 g1 g1 g1 g1 g1 g1 g1 g1 g1 g1 g1 g1 g1 g1 g1 g1 g1
g1 g1 g1 g1 g1 g1 g1 g1 g1 g1 g1 g1 g1 g1 g1 g1 g1 g1 g1 g1 g1 g1 g1 g1 g1 g1 g1 g1 g1 g1 g1 g1 g1 g1 g1 g1 g1 g1 g1 g1 g1 g1 g1 g1 g1 g1 g1 g1 g1 g1 g1 g1 g1 g1 g1 g1 g1 g1 g1 g1 g1 g1 g1 g1 g1 g1 g1 g1 g1 g1 g1 g1 g1 g1 g1 g1 g1 g1 g1 g1
g1 g1 g1 g1 g1 g1 g1 g1 g1 g1 g1 g1 g1 g1 g1 g1 g1 g1 g1 g1 g1 g1 g1 g1 g1 g1 g1 g1 g1 g1 g1 g1 g1 g1 g1 g1 g1 g1 g1 g1 g1 g1 g1 g1 g1 g1 g1 g1 g1 g1 g1 g1 g1 g1 g1 g1 g1 g1 g1 g1 g1 g1 g1 g1 g1 g1 g1 g1 g1 g1 g1 g1 g1 g1 g1 g1 g1 g1 g1 g1
g1 g1 g1 g1 g1 g1 g1 g1 g1 g1 g1 g1 g1 g1 g1 g1 g1 g1 g1 g1 g1 g1 g1 g1 g1 g1 g1 g1 g1 g1 g1 g1 g1 g1 g1 g1 g1 g1 g1 g1 g1 g1 g1 g1 g1 g1 g1 g1 g1 g1 g1 g1 g1 g1 g1 g1 g1 g1 g1 g1 g1 g1 g1 g1 g1 g1 g1 g1 g1 g1 g1 g1 g1 g1 g1 g1 g1 g1 g1 g1
g1 g1 g1 g1 g1 g1 g1 g1 g1 g1 g1 g1 g1 g1 g1 g1 g1 g1 g1 g1 g1 g1 g1 g1 g1 g1 g1 g1 g1 g1 g1 g1 g1 g1 g1 g1 g1 g1 g1 g1 g1 g1 g1 g1 g1 g1 g1 g1 g1 g1 g1 g1 g1 g1 g1 g1 g1 g1 g1 g1 g1 g1 g1 g1 g1 g1 g1 g1 g1 g1 g1 g1 g1 g1 g1 g1 g1 g1 g1 g1
g1 g1 g1 g1 g1 g1 g1 g1 g1 g1 g1 g1 g1 g1 g1 g1 g1 g1 g1 g1 g1 g1 g1 g1 g1 g1 g1 g1 g1 g1 g1 g1 g1 g1 g1 g1 g1 g1 g1 g1 g1 g1 g1 g1 g1 g1 g1 g1 g1 g1 g1 g1 g1 g1 g1 g1 g1 g1 g1 g1 g1 g1 g1 g1 g1 g1 g1 g1 g1 g1 g1 g1 g1 g1 g1 g1 g1 g1 g1 g1
g1 g1 g1 g1 g1 g1 g1 g1 g1 g1 g1 g1 g1 g1 g1 g1 g1 g1 g1 g1 g1 g1 g1 g1 g1 g1 g1 g1 g1 g1 g1 g1 g1 g1 g1 g1 g1 g1 g1 g1 g1 g1 g1 g1 g1 g1 g1 g1 g1 g1 g1 g1 g1 g1 g1 g1 g1 g1 g1 g1 g1 g1 g1 g1 g1 g1 g1 g1 g1 g1 g1 g1 g1 g1 g1 g1 g1 g1 g1 g1
g1 g1 g1 g1 g1 g1 g1 g1 g1 g1 g1 g1 g1 g1 g1 g1 g1 g1 g1 g1 g1 g1 g1 g1 g1 g1 g1 g1 g1 g1 g1 g1 g1 g1 g1 g1 g1 g1 g1 g1 g1 g1 g1 g1 g1 g1 g1 g1 g1 g1 g1 g1 g1 g1 g1 g1 g1 g1 g1 g1 g1 g1 g1 g1 g1 g1 g1 g1 g1 g1 g1 g1 g1 g1 g1 g1 g1 g1 g1 g1
g1 g1 g1 g1 g1 g1 g1 g1 g1 g1 g1 g1 g1 g1 g1 g1 g1 g1 g1 g1 g1 g1 g1 g1 g1 g1 g1 g1 g1 g1 g1 g1 g1 g1 g1 g1 g1 g1 g1 g1 g1 g1 g1 g1 g1 g1 g1 g1 g1 g1 g1 g1 g1 g1 g1 g1 g1 g1 g1 g1 g1 g1 g1 g1 g1 g1 g1 g1 g1 g1 g1 g1 g1 g1 g1 g1 g1 g1 g1 g1
g1 g1 g1 g1 g1 g1 g1 g1 g1 g1 g1 g1 g1 g1 g1 g1 g1 g1 g1 g1 g1 g1 g1 g1 g1 g1 g1 g1 g1 g1 g1 g1 g1 g1 g1 g1 g1 g1 g1 g1 g1 g1 g1 g1 g1 g1 g1 g1 g1 g1 g1 g1 g1 g1 g1 g1 g1 g1 g1 g1 g1 g1 g1 g1 g1 g1 g1 g1 g1 g1 g1 g1 g1 g1 g1 g1 g1 g1 g1 g1
s1 s1 s2 s1 s1 s1 s1 s1 s1 s1 s1 g1 g1 g1 g1 g1 g1 g1 g1 g1 g1 g1 g1 g1 g1 g1 g1 g1 g1 g1 g1 g1 g1 g1 g1 g1 g1 g1 g1 g1 g1 g1 g1 g1 g1 g1 g1 g1 g1 g1 g1 g1 g1 g1 g1 g1 g1 g1 g1 g1 g1 g1 g1 g1 g1 g1 g1 g1 g1 g1 g1 g1 g1 g1 g1 g1 g1 g1 g1 g1
s1 s1 s2 s1 s1 s1 s1 s1 s1 s1 s1 g1 g1 g1 g1 g1 g1 g1 g1 g1 g1 g1 g1 g1 g1 g1 g1 g1 g1 g1 g1 g1 g1 g1 g1 g1 g1 g1 g1 g1 g1 g1 g1 g1 g1 g1 g1 g1 g1 g1 g1 g1 g1 g1 g1 g1 g1 g1 g1 g1 g1 g1 g1 g1 g1 g1 g1 g1 g1 g1 g1 g1 g1 g1 g1 g1 g1 g1 g1 g1
s1 s1 s2 s1 s1 s1 s1 s1 s1 s1 s1 g1 g1 g1 g1 g1 g1 g1 g1 g1 g1 g1 g1 g1 g1 g1 g1 g1 g1 g1 g1 g1 g1 g1 g1 g1 g1 g1 g1 g1 g1 g1 g1 g1 g1 g1 g1 g1 g1 g1 g1 g1 g1 g1 g1 g1 g1 g1 g1 g1 g1 g1 g1 g1 g1 g1 g1 g1 g1 g1 g1 g1 g1 g1 g1 g1 g1 g1 g1 g1
s1 s1 s2 s1 s1 s1 s1 g1 g1 g1 g1 g1 g1 g1 g1 g1 g1 g1 g1 g1 g1 g1 g1 g1 g1 g1 g1 g1 g1 g1 g1 g1 g1 g1 g1 g1 g1 g1 g1 g1 g1 g1 g1 g1 g1 g1 g1 g1 g1 g1 g1 g1 g1 g1 g1 g1 g1 g1 g1 g1 g1 g1 g1 g1 g1 g1 g1 g1 g1 g1 g1 g1 g1 g1 g1 g1 g1 g1 g1 g1
s1 s1 s2 s1 s1 s1 s1 g1 g1 g1 g1 g1 g1 g1 g1 g1 g1 g1 g1 g1 g1 g1 g1 g1 g1 g1 g1 g1 g1 g1 g1 g1 g1 g1 g1 g1 g1 g1 g1 g1 g1 g1 g1 g1 g1 g1 g1 g1 g1 g1 g1 g1 g1 g1 g1 g1 g1 g1 g1 g1 g1 g1 g1 g1 g1 g1 g1 g1 g1 g1 g1 g1 g1 g1 g1 g1 g1 g1 g1 g1
s1 s1 s2 s1 s1 s1 s1 g1 g1 g1 g1 g1 g1 g1 g1 g1 g1 g1 g1 g1 g1 g1 g1 g1 g1 g1 g1 g1 g1 g1 g1 g1 g1 g1 g1 g1 g1 g1 g1 g1 g1 g1 g1 g1 g1 g1 g1 g1 g1 g1 g1 g1 g1 g1 g1 g1 g1 g1 g1 g1 g1 g1 g1 g1 g1 g1 g1 g1 g1 g1 g1 g1 g1 g1 g1 g1 g1 g1 g1 g1
s1 s1 s2 s1 s1 s1 s1 g1 g1 g1 g1 g1 g1 g1 g1 g1 g1 g1 g1 g1 g1 g1 g1 g1 g1 g1 g1 g1 g1 g1 g1 g1 g1 g1 g1 g1 g1 g1 g1 g1 g1 g1 g1 g1 g1 g1 g1 g1 g1 g1 g1 g1 g1 g1 g1 g1 g1 g1 g1 g1 g1 g1 g1 g1 g1 g1 g1 g1 g1 g1 g1 g1 g1 g1 g1 g1 g1 g1 g1 g1
s1 s1 s2 s1 s1 s1 s1 g1 g1 g1 g1 g1 g1 g1 g1 g1 g1 g1 g1 g1 g1 g1 g1 g1 g1 g1 g1 g1 g1 g1 g1 g1 g1 g1 g1 g1 g1 g1 g1 g1 g1 g1 g1 g1 g1 g1 g1 g1 g1 g1 g1 g1 g1 g1 g1 g1 g1 g1 g1 g1 g1 g1 g1 g1 g1 g1 g1 g1 g1 g1 g1 g1 g1 g1 g1 g1 g1 g1 g1 g1
s1 s1 s2 s1 s1 s1 s1 g1 g1 g1 g1 g1 g1 g1 g1 g1 g1 g1 g1 g1 g1 g1 g1 g1 g1 g1 g1 g1 g1 g1 g1 g1 g1 g1 g1 g1 g1 g1 g1 g1 g1 g1 g1 g1 g1 g1 g1 g1 g1 g1 g1 g1 g1 g1 g1 g1 g1 g1 g1 g1 g1 g1 g1 g1 g1 g1 g1 g1 g1 g1 g1 g1 g1 g1 g1 g1 g1 g1 g1 g1
s1 s1 s2 s1 s1 s1 s1 g1 g1 g1 g1 g1 g1 g1 g1 g1 g1 g1 g1 g1 g1 g1 g1 g1 g1 g1 g1 g1 g1 g1 g1 g1 g1 g1 g1 g1 g1 g1 g1 g1 g1 g1 g1 g1 g1 g1 g1 g1 g1 g1 g1 g1 g1 g1 g1 g1 g1 g1 g1 g1 g1 g1 g1 g1 g1 g1 g1 g1 g1 g1 g1 g1 g1 g1 g1 g1 g1 g1 g1 g1
s1 s1 s2 s1 s1 s1 s1 g1 g1 g1 g1 g1 g1 g1 g1 g1 g1 g1 g1 g1 g1 g1 g1 g1 g1 g1 g1 g1 g1 g1 g1 g1 g1 g1 g1 g1 g1 g1 g1 g1 g1 g1 g1 g1 g1 g1 g1 g1 g1 g1 g1 g1 g1 g1 g1 g1 g1 g1 g1 g1 g1 g1 g1 g1 g1 g1 g1 g1 g1 g1 g1 g1 g1 g1 g1 g1 g1 g1 g1 g1